#######################################
#............................#........#
#..........#.................#........#
#..........#............@....#........#
#..........###################........#
#................#....................#
#..........       .....Z..............#
## ##.## ##         ..................#
#............       ###############...#
#..............  #............#.......#
#................#.....#......#.......#
#................#.....#......#.......#
#.......Z........#.....#......#.......#
#......................#..............#
#######################################
