#################
#...............#
#..#............#
#....###........#
#....#@#....#...#
#...............#
#..#......#.....#
#......#........#
#...#...........#
#################