#######################################
#.....................................#
#.....................................#
#.....@...............................#
#.....................................#
#.....................................#
#.....................................#
#.....................................#
#.....................................#
#.....................................#
#.....................................#
#.....................................#
#.....................................#
#.....................................#
#.....................................#
#.....................................#
#.....................................#
#.....................................#
#.....................................#
#.....................................#
#.....................................#
#.....................................#
#.....................................#
#.....................................#
#.....................................#
#.....................................#
#.....................................#
#######################################